11111111111
1P0000C00E1
10000111111
10000100001
10000C00001
11111111001
10000C10001
10000000001
11111111111
