111111111111111111111111111111111
1P0000C0000000000E100000000000001
100001111111111111111111111111111
100001000000000000100000000000001
10000C000000000000111111111111111
111111110011111111111111111111111
10000C100000000000000000000000001
100000000011111111111111111111111
111111111111111111111111111111111
